///// CYAN /////

AwkwardTitle = That was awkward...
AwkwardText = Being denied a hug
CookiesTitle = You're a fat girl, Becky
CookiesText = Eat 100 cookies
InTheToiletTitle = Always in 3rd spot
InTheToiletText = Found the keys in the WC
FruitTitle = Cyber-Vegetarian
FruitText = Eat a virtual fruit
FirstKillTitle = Meat pancake
FirstKillText = Eliminate Alicia

///// GREEN /////

///// YELLOW /////

BrokenHeartTitle = Broken Heart
BrokenHeartText = Refuse to go out with Marie
ThatWasAnAccidentTitle = That was an accident...
ThatWasAnAccidentText = Die because of a couch
GoldenShowerTitle = Golden Shower
GoldenShowerText = To be urinated on...
TerminatedTitle = TERMINATED!
TerminatedText = Permanent death on a terminator

///// ORANGE /////

BonusTitle = Unlocked : BONUS menu
BonusText = finish the demo

///// RED /////

SignOfStoppingTitle = Sign of stopping
SignOfStoppingText = relaunch the game 5 times
ComingForYouTitle = I'm coming for you
ComingForYouText = 	

///// PURPLE /////

NothingNextTitle = Well played! But...
NothingNextText = The game didn't plan no sequel